w,w,w,w,w,w,w,w,w,w,w,w,w,w,w,w,w,w,w,w,
w, , , , , , , , , , , , , , , , , , ,w,
w, , , , , , , , , , , , , , , , , , ,w,
w, , , , , , , , , , , , , , , , , , ,w,
w, , , , , , , , , , , , , , , , , , ,w,
w, , , , , , , , , , , , , , , , , , ,w,
w, , , , , , , , , , , , , , , , , , ,w,
w, , , , , , , , , , , , , , , , , , ,w,
w, , , , , , , , , , , , , , , , , , ,w,
d:2:18:9, , , , , , , , , , , , , , , , , , ,w,
w, , , , , , , , , , , , ,c, , , , , ,w,
w, , , , , , , , , , , , , , , , , , ,w,
w, , , , , , , , , , , , , , , , , , ,w,
w, , , , , , , , , , , , , , , , , , ,w,
w, , , , , , , , , , , , , , , , , , ,w,
w, , , , , , , , , , , , , , , , , , ,w,
w, , , , , , , , , , , , , , , , , , ,w,
w, , , , , , , , , , , , , , , , , , ,w,
w, , , , , , , , , , , , , , , , , , ,w,
w,w,w,w,w,w,w,w,w,w,w,w,w,w,w,w,w,w,w,w,