w,w,w,w,w,w,w,w,w,w,w,w,w,w,w,w,w,w,w,w,
w, , , , , , , , , , , , , , , , , , ,w,
w, , , , , , , , , , , , , , , , , , ,w,
w, , , , , , , , , , , , , , , , , , ,w,
w, , , , , , , , , , , , , , , , , , ,w,
w, , , , , , , , , , , , , , , , , , ,w,
w, , , , , , , , , , , , , , , , , , ,w,
w, , , , , , , , , , , , , , , , , , ,w,
w, , , , , , , , , , , , , , , , , , ,w,
w, , , , , , , , , , , , , , , , , , ,d:2:1:9,
w, , , , , , , , , , , , ,c, , , , , ,w,
w, , , , , , , , , , , , , , , , , , ,w,
w, , , , , , , , , , , , , , , , , , ,w,
w, , , , , , , , , , , , , , , , , , ,w,
w, , , , , , , , , , , , , , , , , , ,w,
w, , , , , , , , , , , , , , , , , , ,w,
w, , , , , , , , , , , , , , , , , , ,w,
w, , , , , , , , , , , , , , , , , , ,w,
w, , , , , , , , , , , , , , , , , , ,w,
w,w,w,w,w,w,w,w,w,w,w,w,w,w,w,w,w,w,w,w,